########################
#                      #
# ** ** *** *** ** *** #
# ** ## *** *** ** *** #
# ** ## *** *** ** *** #
# ** ** *** *** ** *** #
# ** **         ## *** #
# ** ** *** *** ** *** #
#                      #
####     #####      ####
#                      #
# ** ** *** *** ** *** #
#                      #
# ** ** ### *** ** *** #
#                      #
# **    *** ###    *** #
#                      #
# ** **         ** *** #
# ** ## *** *** ** *** #
# ** ** *** *** ## *** #
# ** ** *** *** ## *** #
# ** ** *** *** ** *** #
#                      #
########################