################################
#                 *    ## ##   #
###*####  ##**##        ##     #
###***##  ##***##       **     #
# *##*##   ##** ##      ##     #
# *##**#   ##*          ##     #
#                   ######     #
#      ##                      #
#    ####                      #
#    ##      ##*   ##          #
#            ***               #
#       ##              ##     #
#                              #
#       ##      ##           ###
#   #                          #
################################